NO ./texture/north.xpm
SO ./texture/south.xpm
WE ./texture/west.xpm
EA ./texture/east.xpm
F  150,   255,   150
C  150,   255, 255


1111111111
1000000001
10N0000001
1001000001
1000000001
1000000001
1111111111
